
NO 


1111111111111111111111111111111111111
1000000000000000000000000000000000001
1000001000000000000000000000000000001
1000000000000000000000000000000000001
1000000000000000000000000000000000001
1001000000000000000000000000000000001
1000000000001111110000000000000000001
1001000000000000000000000000000000001
1000000000000000000000000000000000101
100100000N000000000000000000000000001
10000000000000000000000000000000000011111
1111111111111111111111111111111111111