111111111111111111111111111111111111111
100000000000000000000000000000000000001
100000000000000000000000000000000000001
1000000000100000000000DDDDD000000000001
100000000000000000000000000000000000001
100000000000000000000000N00000000000001
100000000000000000000000000000000000001
100000000000000000000000000000000100001
100000000000000000000000000000000000001
100000000000000000000000000000000000001
100000100000000000000000000000000000001
100000000000000000000000000000000000001
111111111111111111111111111111111111111
