   NO		textures/first.xpm
SO textures/second.xpm
WE          		 textures/third.xpm
EA textures/fifth.xpm
F    	220,100,0
C 225,30,0



111111111111111111111111111111111
111100000000000000000000000000011
111100000000000000000000000000011
111100000000000000000000000000011
111100000000000000000000000000011
11110000000011D111D11100000000011
111100000000000000000000000000011
111100000000000000N00000000000011
111111111111111111111111111111111
111111111111111111111111111111111


