NO AnyConv.com__fin.xpm
SO images.xpm
WE images.xpm
EA images.xpm

F 220,100,0
C 225,30,0

	 						111111111111111111111
	 						1111111111111111111 
	 						111111111111111111111
1111111111111111111111111111111111               
10000000001100000000000111111111
101100001011100000N00000111111111
100100000000000000001001111111111111111111
1111111111111111111111000111111111111111111111111
    	11111111111000000111000000000000000001
	111111111111111111110111111111111111111111111
11111111111111111111111101111111         
100000000011000001110110011111111
1111011111111101110000001000101
111101111111110111010100100011
110000001101010111000000100011
1000000000000000110000001000101
100000000000000011010101000011
110000011101010001110111100111
  111111111111111111111111111
  111111111111111111111111111
11110111 11101011 101111010001
11111111 11111111 111111111111
1111111111111111111111111
1111111111111111111111111
1


