   NO		textures/east.xpm
SO textures/tmp_south.xpm
WE          		 textures/weast.xpm
EA textures/east.xpm
C 0,   0 ,0
F   50,   50,50
               111
1111111111111111D11111111111111111
111100000010000000000010000000001
111100000010000000000010000000011
111100000010000000000010000000011
1111000000000000D0000000000000011
11110000000011D111D11100000000011
111100000000000000N00000000000011
111100000000000000000000000000011
111111111111111111111111111111111
1111111111111D1111111111111111111
111111111111111111111111111111111

