   NO		textures/first.xpm
SO textures/second.xpm
WE          		 textures/third.xpm
EA textures/fifth.xpm
C 233,   208 ,200
F    0,   100,0

111111111111111111111111111111111
11110000000000000000000000000000N1
111100000000000000000000000000011
111100000000000000000000000000011
111100000000000000000000000000011
11110000000011D111D11100000000011
111100000000000000000000000000011
111100000000000000000000000000011
111111111111111111111111111111111
111111111111111111111111111111111

