   NO		textures/first.xpm
SO textures/second.xpm
WE          		 textures/third.xpm
EA textures/fifth.xpm
C 53,   100 ,203
F   150,   100,203

111111111111111111111111111111111
1111000000000000000000000000000N1
111100000000000000000000000000011
111100000000000000000000000000011
111100000000000000000000000000011
11110000000011D111D11100000000011
111100000000000000000000000000011
111100000000000000000000000000011
111111111111111111111111111111111
1111111111111D1111111111111111111
111111111111111111111111111111111

